Ala	GCU,GCC,GCA,GCG
Cys	UGU,UGC
Sec	UGA
Asp	GAU,GAC
Glu	GAA,GAG
Phe	UUU,UUC
Gly	GGU,GGC,GGA,GGG
His	CAU,CAC
Ile	AUU,AUC,AUA
Lys	AAA,AAG
Pyl	UAG
Leu	UUA,UUG,CUU,CUC,CUA,CUG
Met	AUG
Asn	AAU,AAC
Pro	CCU,CCC,CCA,CCG
Gln	CAA,CAG
Arg	CGU,CGC,CGA,CGG,AGA,AGG
Ser	UCU,UCC,UCA,UCG,AGU,AGC
Thr	ACU,ACC,ACA,ACG
Val	GUU,GUC,GUA,GUG
Trp	UGG
Tyr	UAU,UAC,UAG
Term	UAA
GCUUGUUGAGAUUAA
AAUCCUUAA
